8 7
5 5
1 1 1 1 1 1 1 1
1 1 0 0 1 1 1 1
1 0 0 0 0 0 0 1
1 0 3 3 1 2 0 1
1 1 1 0 0 2 0 1
1 1 1 1 1 0 0 1
1 1 1 1 1 1 1 1
#