8 6
6 3
1 1 1 1 1 1 1 1
1 0 0 1 1 1 1 1
1 0 0 3 4 3 0 1
1 0 2 0 2 0 0 1
1 0 0 0 1 1 1 1
1 1 1 1 1 1 1 1
#