7 8
5 4
1 1 1 1 1 1 1
1 1 1 0 0 1 1
1 0 0 0 0 1 1
1 0 1 0 3 3 1
1 0 2 2 2 0 1
1 1 1 0 1 0 1
1 1 1 0 0 3 1
1 1 1 1 1 1 1
#