9 6
5 2
1 1 1 1 1 1 1 1 1
1 0 0 1 1 1 1 1 1
1 0 3 4 3 1 4 0 1
1 1 0 0 1 2 0 0 1
1 1 1 0 0 0 1 1 1
1 1 1 1 1 1 1 1 1
#