8 8
5 1
1 1 1 1 1 1 1 1
1 1 1 0 0 0 1 1
1 0 0 2 3 0 1 1
1 0 0 0 2 3 0 1
1 1 1 0 4 6 0 1
1 1 1 0 0 0 0 1
1 1 1 1 1 1 1 1
1 1 1 1 1 1 1 1
8 8
4 6
1 1 1 1 1 1 1 1
1 3 3 2 3 3 1 1
1 3 0 1 0 3 1 1
1 0 2 1 2 0 1 1
1 0 0 1 0 0 1 1
1 0 2 2 2 0 1 1
1 0 0 0 0 0 1 1 
1 1 1 1 1 1 1 1
#
