8 8
1 3
1 1 1 1 1 1 1 1
1 1 1 0 0 0 0 1
1 1 1 2 2 2 0 1
1 0 0 2 0 3 0 1
1 0 6 3 3 3 1 1
1 1 1 1 0 0 1 1
1 1 1 1 1 1 1 1
1 1 1 1 1 1 1 1
8 8
5 4
1 1 1 1 1 1 1 1
1 1 0 0 1 1 1 1
1 1 0 0 1 1 1 1
1 1 0 3 3 4 0 1
1 1 0 2 2 0 0 1
1 0 0 0 1 1 1 1
1 0 0 0 1 1 1 1
1 1 1 1 1 1 1 1
#
