9 7
3 5
1 1 1 1 1 1 1 1 1
1 0 0 0 0 0 1 1 1
1 0 2 2 2 1 1 1 1
1 0 0 1 3 3 1 1 1
1 1 0 0 3 3 2 0 1
1 1 0 0 0 0 0 0 1
1 1 1 1 1 1 1 1 1
#